1111111111111
1C00000000001
1000001111001
1P0011E000001
1111111111111
