1111111111111
1C00X000P0001
1000000E00001
10000S0000001
1111111111111
