1111111111111
1C00000P00001
1000P000E0001
1000000P00001
1111111111111
