1111111111111
1C00000001
10000P00001
1000E000001
1111111111111
