1111111111111
1C000000P0001
1000000C00001
1000000C00001
1111111111111
