1111111111111
1C00000000001
1000000E00001
1000000C00001
1111111111111
