11111111111
1C000000001
100000P0001
1000E000001
11111011111
