11111111111111
1C0000001C0001
11111111100001
1P0000E0000001
11111111111111
