11111111111111111
10000000C00000001
10111111111111101
10100000000000101
101C1111111110101
10100000P00000101
10111111111110101
100000000C0000101
10111111111110101
10100000E00000101
11111111111111111
