1111111111111111111111
1C000000000000000C0001
1011110111110111110101
1000010000010000010101
1011110111110111110101
1010000000P00000000101
1010110111110111110101
1010010000010000010101
1011110111110111110101
100C000000E000000C0001
1111111111111111111111
